..........................
..........................
..##..##..##..##..##..##..
..##..##..##..##..##..##..
..##..##..##..##..##..##..
..##..##..##..##..##..##..
..##..##..##%%##..##..##..
..##..##..##%%##..##..##..
..##..##..##..##..##..##..
..##..##..##..##..##..##..
..##..##..........##..##..
..........................
##........##..##........##
##........##..##........##
%%..####..........####..%%
....####..##..##..####....
..........######..........
..........######..........
..##..##..##..##..##..##..
..##..##..##..##..##..##..
..##..##..##..##..##..##..
..##..##..........##..##..
..##..##..........##..##..
..##..##..........##..##..
..........................
..........................
