..........................
..........................
..##..##..##..##..##..##..
..##..##..##..##..##..##..
..##..##..##..##..##..##..
..##..##..##..##..##..##..
..##..##..######..##..##..
..##..##..######..##..##..
..##..##..##..##..##..##..
..##..##..##..##..##..##..
..##..##..........##..##..
..........................
##........##..##........##
##........##..##........##
....####..........####....
....####..%%..%%..####....
..........%%%%%%..........
..........%%%%%%..........
..##..##..%%..%%..##..##..
..##..##..%%..%%..##..##..
..##..##..%%..%%..##..##..
..##..##..........##..##..
..##..##..........##..##..
..##..##..........##..##..
..........................
..........................
